111111111111111111111111111111111111111
166666666666666666666666666666666666661
161111116116111111666111111611611111161
161666666666666661666166666666666666161
161611111111111161666161111111111116161
161616666666666161666161666666666616161
166616111111116166666661611111111616661
161616188888876161696161618888887616161
161666188888816661666166618888881666161
161616111111116161666161611111111616161
166616666666666166666661666666666616661
161611111111111161666161111111111116161
161666666666666661606166666666666666161
161611116116111161666161111611611116161
161666616666166661666166661666616666161
161111611111161111666111161111116111161
166666666666666666666666666666666666661
111111111111111111111111111111111111111