1111111111111111111111111111111111111111
1000000000000000000000000000000000000001
1011111101101111110000111111011011111101
1010000000000000010000100000000000000101
1010111111111111010000101111111111110101
1010100000000001010000101000000000010101
1000101111111101000000001011111111010001
1010101888888701010000101018888887010101
1010001888888100010000100018888881000101
1010101111111101010000101011111111010101
1000100000000001000090001000000000010001
1010111111111111010000101111111111110101
1010000000000000010000100000000000000101
1010111101101111010000101111011011110101
1010000100001000010000100001000010000101
1011110111111011110000111101111110111101
1000000000000000000000000000000000000001
1111111111111111111111111111111111111111