1111111111111111111111111111111111111
1100000000000000000000000000000000011
1101111110110111111111110110111111011
1101000000000000001000000000000001011
1101011111111111101011111111111101011
1101010000000000101010000000000101011
1100010111111110100010111111110100011
1101000111111110001000111111110001011
1101010111111110101010111111110101011
1100010000000000100010000000000100011
1101011111111111101011111111111101011
1101000000000000001000000000000001011
1101011110110111111111110110111101011
1101000010000100009000010000100001011
1101111011111101111111011111101111011
1100000000000000000000000000000000011
1111111111111111111111111111111111111